%%%%%%%%%%%%%%%%%%%%%%
%D*D           DDDODD%
%DOD           DDDODD%
%DDO    R      DDDODD%
%DDDO          DDDODD%
%DDDDO         DDDODD%
%DDDDDO        DDDDDD%
%DDDDDDO             %
%DDDDDDDO            %
%DDDDDDDDO           %
%DDDDDDDDDO          %
%%%%%%%%%%%%%%%%%%%%%%
