%%%%%%%%%%%%%%%%%%%%%%
%D*D      #*#  DDDO#D%
%DOD       *   DDDO#D%
%DDO    R  D   DDDO#D%
%DDDO          DDDO#D%
%DDDDO         DDDO#D%
%DDDDDO        DDDD#D%
%DDDDDDO             %
%DDDDDDDO            %
%DDDDDDDDO           %
%DDDDDDDDDO         E%
%%%%%%%%%%%%%%%%%%%%%%
