%%%%%%%%%%%%%%%%%%%%%%%%%%%%%%%%%%%%%%%%
%DDDDDD DD*DO DDDDDODODDDDDDD DDDDODDDD%
%DORODDDDDD DDDDDDDDDO*DDODDDD DDDDD DD%
%DDDDDDDDDD DDODDDDDODODDODDDDDDDDODDDD%
%ODOODDDDDDDDDODDDDDDODDODDDDODDDODDDDD%
%OD ODDDDDDDDD ODDODDDDDDDDODDDDDDODOOD%
%DDD DDODDDDDDDDODDDDDOD ODDDDDDDDODOOD%
%##############################DDDODDOD%
%D DDDODD*D DDODODDDDDDDDDD*DO*DDDDDD D%
%DD*DDDDDODDDDD DDDDDDDDOO ODDODDDDODDD%
%DDDODDODODDDDDDDDDDDDDDO DODDODDDDDDDD%
%DODDDDDODDDDDDDDOOODDDDDDDODD D*DDDDOD%
%D*DD DDOD  DDDDDODO*DD*DDDDODDDODD*D D%
%D ODDDDDDDDDDDDDDO ODDODDDDDDDD*DDDDDO%
%DDDDDDDD##############################%
% ODDDDDDDDDODDD*DDDDODDDDDODDDODDDDDDD%
% ODDDDDDDDD ODDODDDDDDDDODDDDDDODOODDE%
%D DDODDDDDDDDODDDDDOD  DDDD*DDDODOODDD%
%DDDDO*DDODDDDDDDDODDDDDDODO*DDDDDDODDD%
%DDD DDOD DDODOODDDDDDDDDODO*DDDDDD DDO%
%D*DDDD DDDDD DDDDDDDDD DODOODDDDODDDOD%
%%%%%%%%%%%%%%%%%%%%%%%%%%%%%%%%%%%%%%%%
